############
#         O#
# P     ####
#          #
#######    #
# O ##     #
#   ##     #
#          #
#      XX  #
#       #  #
############
