#####################
#P                  #
#     ##            #
#     ##X           #
# X   O#            #
########            #
#O              X   #
#O                  #
#####################